11111111111111111
1PC00000000000001
10000111110C00001
10000111110C00001
10000111110C00001
10000111110C00001
10E00111110C00001
11111111111111111