11111111111111111111111111111111111111111111111111111111111
1P0000000000000001C11111111111111111C00000C111100000C110111
1111111001111C000000C1100000C111111000000000C000C000C000011
111111110010000C100000C10000000000C000CC100000C100000000001
1111111110111C0000000000000000C111000C000C00000C111CCC00011
111111110011110000000000000C10C100000000C100000C1000C110011
1111111001000001C000C0000000C10000C001CCC10000000011C01C011
1111110011000C111111000000000000000000111000001010000100101
11111001000000111110000011CC00001001111110010000011110100C1
1EC0001C001010100000011110C00011111111111111000000011100011
11111111111111111111111111111111111111111111111111111111111